....%.........%....
.%%.%.%%%%%%%.%.%%.
.%...............%.
.%.%%.%%   %%.%%.%.
......%     %......
.%.%%.%%%%%%%.%%.%.
.%...............%.
.%%.%.%%%%%%%.%.%%.
....%.........%....